Stage 1
######
#  P #
#o####
# #
#O#
###
=====
Stage 2
######
#P   #
#  oO#
# oO #
######
=====
Stage 3
######
#P   #
#Oo o#
#  #O#
######
=====
Stage 4
#######
#P    #
# oo  #
# #O# #
#    O#
#######
=====
Stage 5
  ####
###  #
#P oO##
#   o #
# #O  #
#     #
#######
=====
Stage 6
 #####
## P ##
#  #  #
# oOo #
#  #  #
#  O  #
 #####